1,1,1,1,5,1,1,1,1
1,1,1,5,2,5,1,1,1
1,1,1,5,2,5,1,1,1
1,5,5,2,2,2,5,5,1
5,2,2,2,2,2,2,2,5
1,5,5,2,2,2,5,5,1
1,1,1,5,2,5,1,1,1
1,1,1,5,2,5,1,1,1
1,1,1,1,5,1,1,1,1
